1111111111
1010000001
1011011101
1000010001
1011110111
1010000001
1001111101
1111000001
1010010111
1011010001
1010010101
1000110001
1011111111
10000000$1
1111111111
